1111111
11110P1
1010011
1100111
1001011
1C000E1
1111111
