1111111111111
11111P11CCCE1
1CCCCC1CCCC11
1CCCCC1CCCC11
1CCCCC1CCCC11
1CCCCC1CCCC11
1CCCCC1CCCC11
1CCCCC1CCCC11
1CCCCC1CCCC11
1CCCCC1CCCC11
1CCCCC1CCCC11
1CCCCC1CCCC11
1CCCCCCCCCC11
1111111111111
