11111111111
1P000000001
11111111101
10000000101
10111110101
1C1E0000101
10111111101
1C000000001
11111111111
